{
	"Name": "The mother ship",
	"SizeX": 5,
	"SizeY": 5,
	"Map":[
	1, 1, 1, 1, 1,
	1, 0, 0, 0, 1,
	1, 0, 0, 0, 1,
	1, 0, 0, 0, 1,
	1, 1, 1, 1, 1
	]
}